38 38 38 38 38 38 38 38 38 38 38 38 38 38 38 38 38 38 38 38 38 38 38 38 38 38 38 38 38 38 38 38 38 38 16 16 16 16 16 16 16 16 16 16 16 16 16 16 16 16 16 16 16 16 16 16 16 16 16 16 16 16 16 16 16 16 16 55 55 55 55 55 55 55 55 55 55 55 55 55 55 55 55 55 55 55 55 55 55 55 55 55 55 55 55 55 55 55 55 55 
38 39 49 39 49 39 39 39 39 39 174 39 39 49 39 39 49 39 39 39 39 175 39 39 39 39 39 39 47 39 39 39 39 38 16 16 16 16 16 16 16 16 16 16 16 16 16 16 16 16 16 16 16 16 16 16 16 16 16 16 16 16 16 16 16 16 16 55 54 54 54 54 54 54 54 54 54 54 54 54 54 54 54 54 54 54 54 54 54 54 55 54 63 63 63 63 63 63 63 55 
38 39 39 47 175 49 39 39 47 49 39 49 39 39 47 39 39 39 47 39 47 39 39 49 49 47 39 39 39 174 39 47 47 38 16 16 1 16 1 1 1 1 1 1 1 1 1 1 1 1 1 1 1 1 1 1 1 1 1 1 1 1 1 1 1 16 16 55 54 54 54 54 54 54 54 54 54 54 54 54 54 63 54 54 54 60 54 54 54 54 55 55 63 63 63 63 63 54 63 55 
38 49 175 49 174 39 49 49 39 49 39 39 47 39 174 49 39 47 39 47 39 39 39 47 39 49 39 47 39 47 49 39 39 38 16 16 1 1 1 1 1 2 1 1 1 16 1 1 1 1 1 1 1 1 2 1 1 1 16 1 1 1 2 1 1 16 16 55 60 55 55 55 55 55 55 55 55 55 55 55 55 55 55 55 55 55 55 55 55 54 55 55 63 63 63 63 63 55 63 55 
38 49 39 39 47 39 39 39 39 39 49 39 39 39 47 39 175 39 39 39 49 39 39 47 39 39 175 39 39 39 39 47 39 38 16 16 1 1 1 1 16 1 1 1 1 1 1 1 2 1 1 1 1 1 1 1 1 1 1 1 1 1 1 1 1 16 16 55 54 54 54 54 54 54 63 54 54 54 54 54 54 54 63 54 54 54 54 60 55 54 54 55 63 63 54 63 63 55 63 55 
38 38 38 38 38 38 38 38 38 38 38 38 38 38 38 38 38 38 38 38 38 38 38 38 38 38 38 38 38 39 39 39 49 38 16 16 1 2 1 1 1 1 1 1 2 1 1 1 1 1 1 16 1 1 2 1 1 1 2 1 1 16 1 1 1 16 16 55 54 54 54 60 54 54 54 54 54 54 54 54 54 54 54 54 54 54 54 54 55 54 54 55 55 55 55 55 63 55 63 55 
38 39 39 49 174 39 39 175 39 38 39 39 39 174 49 175 39 39 49 39 39 174 39 39 39 39 39 39 38 39 39 49 39 38 16 16 1 1 1 1 2 1 1 1 1 1 1 1 1 1 1 1 1 1 1 1 1 1 1 1 1 1 1 1 1 16 16 55 54 54 54 63 54 54 54 54 54 54 54 54 54 54 54 54 54 54 54 54 55 55 54 54 63 63 63 55 63 55 63 55 
38 39 47 47 39 39 47 39 39 38 39 39 47 39 39 39 47 39 39 39 39 47 39 49 39 47 39 39 38 47 39 39 175 38 16 16 1 1 1 1 1 1 16 1 1 1 2 1 16 1 1 1 2 1 1 1 1 1 16 1 1 1 1 1 1 16 16 55 60 55 55 55 55 55 55 55 55 55 55 55 55 55 55 55 55 55 54 54 54 55 55 55 55 55 63 55 63 55 63 55 
38 39 39 39 47 39 39 47 39 38 39 39 49 39 47 39 39 39 38 39 39 39 39 39 39 39 175 39 38 39 49 47 174 38 16 16 1 1 1 16 1 1 1 1 1 58 58 58 58 58 58 58 58 58 58 58 58 58 58 58 58 58 58 1 1 16 16 55 54 54 54 54 54 54 54 54 54 60 60 60 60 60 54 54 54 54 55 54 54 54 54 54 63 55 60 55 63 55 63 55 
38 47 49 175 39 39 49 39 39 38 47 39 39 39 39 47 49 39 38 39 39 47 39 47 39 39 49 39 38 39 47 39 39 38 16 16 1 1 1 1 1 2 1 1 1 58 58 58 58 58 58 58 58 16 58 58 58 58 58 58 58 58 58 1 1 16 16 55 54 54 60 54 54 54 54 54 54 54 54 54 54 54 54 54 54 54 54 55 55 55 54 54 63 55 55 55 63 55 63 55 
38 39 47 39 38 39 47 39 49 38 39 39 47 39 39 175 39 39 38 39 49 175 39 39 39 47 39 39 38 49 39 39 47 38 16 16 1 2 1 1 2 1 1 1 16 58 171 171 171 171 171 171 171 171 44 44 44 44 44 44 44 44 44 44 44 16 16 55 54 54 54 54 54 60 54 54 54 54 63 54 54 54 54 54 54 54 54 54 60 54 55 54 63 63 63 63 63 55 63 55 
38 39 47 39 38 39 39 39 47 38 39 175 39 39 174 39 47 39 38 39 39 39 47 39 49 39 39 39 38 39 47 49 39 38 16 16 1 1 16 1 1 1 1 1 1 58 171 171 171 16 171 171 171 171 44 44 44 44 44 44 44 16 44 44 44 16 16 55 60 55 55 55 55 55 55 55 55 55 55 55 55 55 55 55 55 55 55 55 55 54 54 55 55 55 55 63 63 55 63 55 
38 39 39 39 38 49 39 39 39 38 39 49 39 39 47 39 39 39 38 39 39 39 39 174 39 47 39 39 38 39 49 39 39 38 16 16 1 1 1 1 1 1 1 1 1 58 171 171 171 171 171 171 171 171 171 16 44 44 44 44 44 44 44 44 44 16 16 55 54 54 54 54 54 54 54 54 54 54 54 54 54 54 54 54 54 60 54 54 55 54 54 54 63 63 55 55 55 55 63 55 
38 39 47 39 38 39 47 175 39 38 39 39 47 39 39 39 49 39 38 39 47 39 49 39 39 39 39 39 38 39 39 47 39 38 16 16 1 2 1 1 1 2 16 1 1 58 171 171 171 171 171 171 171 171 171 44 44 44 44 44 44 44 44 44 44 16 16 55 54 54 54 54 63 54 54 54 60 54 54 54 63 60 54 54 54 54 54 54 55 54 54 54 63 63 63 63 63 63 63 55 
38 47 39 39 38 39 39 39 39 38 39 39 39 175 39 39 47 39 38 39 39 175 39 39 38 38 38 38 38 47 39 39 39 38 16 16 1 1 1 1 1 1 1 1 1 16 171 171 171 171 171 171 171 171 171 44 44 44 44 44 44 16 44 44 44 16 16 55 60 55 55 55 55 55 55 55 55 55 55 55 55 54 54 54 54 54 54 54 55 54 54 63 63 63 54 63 60 63 63 55 
38 39 39 39 38 47 39 49 47 38 39 47 49 39 47 39 39 39 38 39 49 47 39 47 39 39 174 39 47 175 49 47 39 38 16 16 1 1 16 1 1 1 1 2 1 58 171 171 171 171 171 171 171 171 44 44 44 44 44 44 44 44 44 44 44 16 16 55 54 54 54 54 54 54 54 54 54 54 54 54 54 54 54 54 54 54 54 54 55 55 55 55 55 55 63 63 63 63 63 55 
38 39 39 47 38 39 39 39 39 39 39 39 39 39 39 39 39 39 38 39 39 39 39 39 39 49 39 39 47 39 39 39 39 38 16 16 1 1 1 1 1 1 1 1 1 58 171 171 171 171 16 171 171 171 44 44 16 44 44 44 44 44 44 44 44 16 16 55 54 55 55 55 55 55 55 55 55 55 55 55 55 55 55 55 55 63 63 63 63 63 63 63 63 55 63 63 63 63 63 55 
38 47 39 49 38 38 38 186 186 186 186 186 186 186 186 186 186 186 186 186 186 186 186 186 186 38 38 38 38 38 38 38 38 38 16 16 1 1 2 1 1 1 2 1 1 58 171 171 171 171 171 171 171 171 44 44 44 44 44 44 44 44 16 44 44 16 16 55 51 51 51 51 51 51 51 51 51 51 51 51 51 51 56 56 55 56 56 56 56 56 56 56 56 55 56 56 56 56 60 55 
38 39 175 47 39 39 39 186 68 69 69 69 69 69 69 69 69 69 69 69 69 69 69 70 186 174 39 39 39 39 39 39 49 38 16 16 1 1 1 1 1 1 1 1 1 16 171 171 171 171 171 171 171 171 44 44 44 44 44 44 44 44 44 44 44 16 16 55 51 55 55 55 55 55 55 55 55 55 55 55 55 55 56 56 55 56 56 56 56 56 56 56 56 55 56 56 56 56 60 55 
38 39 39 39 39 47 39 186 52 52 52 52 52 52 52 52 52 52 52 52 52 52 52 52 186 39 39 47 39 49 47 39 39 38 16 16 1 1 2 1 1 1 2 1 1 58 171 171 1 1 16 1 1 171 171 171 171 171 171 171 171 171 171 171 44 16 16 55 51 55 51 51 51 51 51 51 51 51 51 51 51 51 56 56 55 55 55 55 55 55 55 56 56 55 56 60 56 56 60 55 
38 49 39 39 39 39 49 186 52 52 52 52 52 52 52 52 52 52 52 52 52 52 52 52 186 39 49 39 39 39 39 39 39 38 16 16 1 1 16 1 1 1 1 1 1 58 171 171 171 171 171 171 171 171 171 171 16 171 171 171 171 171 171 171 44 16 16 55 51 55 51 51 51 51 51 51 51 51 51 51 51 51 56 56 56 56 63 56 56 56 55 55 55 55 56 56 56 56 60 55 
38 39 47 39 39 47 39 186 52 52 52 52 52 52 52 52 52 52 52 52 52 52 52 52 186 39 47 39 175 39 39 49 39 38 16 16 1 1 1 1 1 2 1 1 2 58 171 171 171 171 171 171 171 171 171 171 171 171 171 171 171 16 171 171 44 16 16 55 51 55 51 51 51 51 51 51 51 51 51 51 51 51 56 56 56 56 56 56 56 56 56 56 55 55 56 56 56 56 60 55 
38 39 39 39 39 39 39 186 52 52 52 52 52 52 52 52 52 52 52 52 52 52 52 52 186 39 39 39 39 174 39 39 39 38 16 16 1 1 1 1 1 1 1 1 1 58 171 16 171 171 171 171 16 171 44 44 44 44 44 44 44 44 44 44 44 16 16 55 51 55 51 51 55 55 55 55 55 55 55 55 55 55 55 55 55 56 56 56 56 56 56 56 56 55 55 56 56 56 60 55 
38 47 39 39 175 39 39 186 52 52 52 52 52 52 52 52 52 52 52 52 52 52 52 52 186 39 47 39 39 39 39 39 39 38 16 16 1 1 1 1 1 1 1 1 1 58 44 44 44 44 44 44 44 44 44 44 16 44 44 44 44 44 44 44 44 16 16 55 51 55 63 55 51 51 51 51 51 51 51 51 51 63 63 56 55 55 60 56 56 60 56 56 56 56 55 56 56 56 60 55 
38 39 39 49 39 39 49 186 52 52 52 52 52 52 52 52 52 52 52 52 52 52 52 52 186 39 39 39 49 39 47 39 175 38 16 16 1 1 2 1 16 1 1 1 1 58 44 44 44 44 44 44 44 44 44 44 44 44 44 44 44 44 44 44 44 16 16 55 51 51 55 51 51 55 55 55 55 55 55 55 55 55 56 56 56 55 55 55 55 55 55 55 55 55 55 55 56 56 60 55 
38 39 39 39 39 39 39 186 52 52 52 52 52 52 52 52 52 52 52 52 52 52 52 52 186 39 39 39 39 39 39 39 39 38 16 16 1 1 1 1 1 1 1 1 1 58 44 44 44 256 44 256 44 44 44 44 44 44 44 44 44 44 44 44 44 16 16 55 51 55 51 51 55 51 51 51 51 51 51 51 51 55 56 56 56 56 56 56 56 56 56 56 56 56 56 55 56 56 60 55 
38 39 39 47 39 47 39 186 98 99 99 99 99 99 99 99 99 99 99 99 99 99 99 100 186 39 39 39 47 39 39 39 49 38 16 16 1 1 1 1 1 2 1 1 1 58 44 44 44 16 44 44 44 44 16 44 44 44 44 44 44 44 16 44 44 16 16 55 51 51 51 55 51 51 51 51 51 51 63 51 51 55 56 56 56 56 56 56 56 56 60 56 56 56 56 55 56 56 60 55 
38 39 49 39 39 39 39 158 159 159 159 159 159 159 159 159 159 159 159 159 159 159 159 159 187 39 49 39 39 39 47 39 39 38 16 16 1 1 1 1 1 1 1 1 1 16 44 44 44 44 44 44 44 44 44 44 44 44 44 44 44 44 44 44 44 16 16 55 51 51 55 51 51 51 51 51 51 51 51 51 51 55 56 56 56 63 56 56 56 56 56 56 56 56 60 55 56 56 60 55 
38 39 47 39 39 49 39 39 39 47 39 39 39 39 39 38 38 39 39 39 39 39 39 39 39 39 174 39 39 39 39 39 39 38 16 16 1 2 1 16 1 1 1 1 1 58 44 256 44 44 256 44 44 44 44 44 44 44 16 44 44 44 44 44 44 16 16 55 51 55 51 51 51 51 51 51 51 51 51 51 51 51 55 56 56 56 56 56 56 56 56 56 56 56 56 55 56 56 60 55 
38 39 39 39 39 39 47 39 39 39 39 39 49 39 39 38 38 49 39 39 47 39 39 49 39 39 39 39 39 39 39 39 39 38 16 16 1 1 1 1 1 1 1 1 2 58 44 44 58 58 58 58 58 58 58 58 58 58 58 58 58 58 58 58 58 16 16 55 51 51 51 51 51 51 63 51 51 51 51 51 51 51 56 55 56 56 56 60 56 56 56 56 56 56 56 55 56 56 60 55 
38 39 39 39 39 39 39 174 39 39 39 47 39 47 39 38 38 39 39 39 39 39 39 49 39 47 39 49 39 39 39 39 39 38 16 16 1 1 1 1 1 1 1 1 1 58 1 1 58 58 58 58 58 58 58 58 58 58 58 58 58 58 58 58 58 16 16 55 51 55 55 55 55 55 55 55 55 55 55 55 55 55 55 55 55 55 55 55 55 55 55 55 55 55 55 55 56 56 60 55 
38 39 49 47 39 39 39 39 49 39 39 39 39 39 39 38 38 39 39 39 39 47 39 39 39 47 39 39 39 39 47 39 39 38 16 16 1 1 1 1 2 1 1 16 1 58 1 1 2 1 1 1 16 1 1 2 1 1 1 1 1 1 1 1 1 16 16 55 51 51 63 51 51 51 51 51 51 51 51 51 51 51 56 55 60 56 56 56 55 56 56 56 56 56 56 55 56 56 60 55 
38 39 39 39 39 49 39 47 39 39 39 39 39 47 39 38 38 39 39 39 39 39 174 39 39 39 39 39 39 39 39 39 39 38 16 16 1 1 16 1 1 1 1 1 1 58 1 1 1 1 1 1 1 1 1 1 1 1 2 1 1 1 1 1 1 16 16 55 51 55 55 55 55 55 55 55 55 55 55 55 55 55 56 55 56 56 56 56 55 56 56 56 56 56 56 55 56 56 60 55 
38 39 39 39 39 39 39 39 39 39 39 49 39 47 39 38 38 39 39 39 39 47 39 39 39 47 39 39 174 39 39 39 39 38 16 16 1 1 1 1 1 1 1 1 1 58 1 1 1 1 1 1 1 1 1 1 1 1 1 2 1 1 1 2 1 16 16 55 51 55 51 51 51 51 51 51 51 51 51 51 51 55 56 55 56 56 56 56 55 56 56 56 60 56 56 55 56 56 60 55 
38 39 39 47 39 39 39 47 47 39 39 39 39 39 39 38 38 39 49 39 39 39 39 39 39 39 47 39 39 39 39 174 39 38 16 16 1 1 1 1 1 1 1 1 1 58 1 16 1 1 1 16 1 1 2 1 1 1 1 1 1 1 16 1 1 16 16 55 51 55 51 51 51 51 51 51 51 51 63 51 51 55 56 55 56 56 56 56 55 56 56 56 56 56 56 55 56 56 60 55 
38 39 39 39 39 175 39 39 49 39 39 39 39 39 39 39 39 47 47 39 39 39 47 39 49 39 47 39 39 49 39 39 39 38 16 16 1 1 1 1 1 1 1 1 1 58 1 1 1 1 1 1 1 1 1 1 1 1 1 1 1 1 1 1 1 16 16 55 51 55 51 51 51 51 51 51 51 51 51 51 51 55 56 56 55 56 56 56 55 56 56 56 56 55 55 55 56 56 60 55 
38 39 49 39 39 39 39 39 39 39 39 47 39 39 39 39 39 39 175 39 39 49 39 39 39 39 39 39 47 39 39 39 39 38 16 16 1 1 1 1 1 1 1 1 1 58 1 1 1 2 1 1 1 1 1 1 16 1 1 1 2 1 1 1 1 16 16 55 51 55 51 63 51 51 51 51 51 55 55 55 55 55 55 56 56 55 56 56 55 56 56 56 56 60 56 55 56 56 60 55 
38 39 39 47 39 39 39 174 39 39 47 39 39 49 39 38 38 39 39 39 39 39 175 39 39 39 39 175 39 39 39 39 39 38 16 16 1 1 1 1 1 1 1 1 1 58 16 1 1 1 1 1 1 1 1 1 1 1 1 1 1 1 1 1 1 16 16 55 51 55 51 51 51 51 51 51 51 55 51 51 51 51 55 56 56 56 55 56 55 55 55 55 55 55 56 55 56 56 60 55 
38 39 39 39 39 39 39 39 39 39 39 175 39 39 39 38 38 39 39 39 47 39 39 39 47 39 39 39 47 47 39 47 39 38 16 16 1 1 1 1 1 1 1 1 1 58 1 1 1 16 1 1 1 1 1 2 1 1 1 1 1 1 1 1 1 16 16 55 51 55 55 55 55 51 55 51 51 55 51 51 51 51 55 56 56 56 55 56 55 56 56 56 56 55 56 55 56 56 60 55 
38 39 39 174 49 39 47 39 49 39 39 47 39 39 39 38 38 39 49 47 39 39 39 47 39 39 39 39 39 39 39 39 39 38 16 16 1 1 1 1 1 1 1 1 1 58 1 1 1 1 1 1 1 1 1 1 1 1 1 1 1 1 2 1 1 16 16 55 51 51 51 51 51 51 55 51 51 55 55 55 55 51 55 56 56 56 55 56 55 56 56 56 56 55 56 55 56 56 60 55 
38 39 39 39 39 39 39 39 39 39 39 39 174 39 39 38 38 39 39 39 39 39 39 39 39 49 39 39 39 39 49 39 39 38 16 16 1 2 1 16 1 1 1 1 1 58 16 1 1 1 1 1 1 1 16 1 1 1 1 16 1 1 1 1 1 16 16 55 55 55 55 51 51 51 55 51 51 63 51 51 55 51 55 56 56 55 56 56 55 56 56 56 56 55 56 55 56 56 60 55 
38 39 39 47 39 175 39 39 47 39 47 39 39 39 39 38 38 39 47 39 39 39 39 39 39 39 39 39 47 39 39 39 39 16 16 16 1 1 1 1 1 1 1 1 1 58 1 1 1 1 1 1 1 1 1 1 1 1 2 1 1 1 1 2 1 51 51 51 51 55 55 63 51 51 55 51 51 51 51 51 55 51 55 56 55 56 56 55 56 60 55 55 55 55 51 55 55 56 60 55 
38 39 49 39 47 39 39 47 39 39 39 175 39 49 39 38 38 39 39 39 49 39 47 39 39 39 175 39 39 39 49 47 39 171 171 171 1 1 1 1 1 1 1 1 1 58 1 1 1 1 1 1 1 1 1 1 1 1 1 1 1 1 1 1 1 51 51 51 51 51 55 55 55 51 55 55 55 55 55 55 55 51 55 55 60 56 55 56 56 56 56 56 56 56 56 56 55 56 51 55 
38 39 39 39 39 39 39 39 39 39 49 39 39 39 39 38 38 39 39 39 39 39 39 39 39 39 39 47 39 39 39 39 39 16 16 16 16 16 16 16 16 16 16 16 16 16 16 16 16 16 16 16 16 16 16 16 16 16 16 16 16 16 16 16 16 16 16 55 51 51 51 51 51 51 51 51 51 51 51 51 51 51 60 56 56 56 56 56 56 56 56 56 56 56 56 56 55 56 51 55 
137 137 137 137 137 137 137 137 137 137 137 137 137 137 137 137 137 137 137 137 137 137 137 137 137 137 137 137 137 137 137 137 137 16 16 16 16 16 16 16 16 16 16 16 16 16 16 16 16 16 16 16 16 16 16 16 16 16 16 16 16 16 16 16 16 16 16 55 55 55 55 55 55 55 55 55 55 55 55 55 55 55 55 55 55 55 55 55 55 55 55 55 55 55 55 55 55 13 13 55 
16 142 142 142 142 142 142 142 142 142 142 142 142 142 142 142 142 142 142 142 142 142 142 142 142 142 142 142 142 142 142 142 142 142 142 142 142 142 142 142 142 142 142 142 142 142 142 142 142 142 142 142 142 142 142 142 142 142 142 142 142 142 142 142 142 142 142 142 142 142 142 142 142 142 142 142 142 142 142 142 142 142 142 142 142 142 142 142 142 142 142 142 142 142 142 142 142 13 13 16 
16 165 59 59 59 59 59 59 59 59 59 59 59 59 59 59 59 59 59 59 59 59 59 59 59 59 59 59 59 59 59 59 59 59 59 59 59 59 59 59 59 59 59 59 59 59 59 59 59 59 59 59 59 59 59 59 59 59 59 59 59 59 59 59 59 59 59 59 59 59 59 59 59 59 59 59 59 59 59 59 59 59 59 59 59 59 59 59 59 59 59 59 59 59 59 59 59 59 13 16 
16 165 59 59 59 59 59 59 59 59 59 59 59 59 59 59 59 59 59 59 59 59 59 59 59 59 59 59 59 59 59 59 59 59 59 59 59 59 59 59 59 59 59 59 59 59 59 59 59 59 59 59 59 59 59 59 59 59 59 59 59 59 59 59 59 59 59 59 59 59 59 59 59 59 59 59 59 59 59 59 59 59 59 59 59 59 59 59 59 59 59 59 59 59 59 59 59 59 165 16 
16 165 59 59 59 59 59 59 59 59 59 59 59 59 59 59 59 59 59 59 59 59 59 59 59 59 59 59 59 59 59 59 59 59 59 59 59 59 59 59 59 59 59 59 59 59 59 59 59 59 59 59 59 59 59 59 59 59 59 59 59 59 59 59 59 59 59 59 59 59 59 59 59 59 59 59 59 59 59 59 59 59 59 59 59 59 59 59 59 59 59 59 59 59 59 59 59 59 165 16 
16 165 59 59 59 59 59 59 59 59 59 59 59 59 59 59 59 59 59 59 59 59 59 59 59 59 59 59 59 59 59 59 59 59 59 59 59 59 59 59 59 59 59 59 59 59 59 59 59 59 59 59 59 59 59 59 59 59 59 59 59 59 59 59 59 59 59 59 59 59 59 59 59 59 59 59 59 59 59 59 59 59 59 59 59 59 59 59 59 59 59 59 59 59 59 59 59 59 165 16 
16 165 59 59 59 59 59 59 59 59 59 59 59 59 59 59 59 59 59 59 59 59 59 59 59 59 59 59 59 59 59 59 59 59 59 59 59 59 59 59 59 59 59 59 59 59 59 59 59 59 59 59 59 59 59 59 59 59 59 59 59 59 59 59 59 59 59 59 59 59 59 59 59 59 59 59 59 59 59 59 59 59 59 59 59 59 59 59 59 59 59 59 59 59 59 59 59 59 165 16 
16 165 59 59 59 59 59 59 59 59 59 59 59 59 59 59 59 59 59 59 59 59 59 59 59 59 59 59 59 59 59 59 59 59 59 59 59 59 59 59 59 59 59 59 59 59 59 59 59 59 59 59 59 59 59 59 59 59 59 59 59 59 59 59 59 59 59 59 59 59 59 59 59 59 59 59 59 59 59 59 59 59 59 59 59 59 59 59 59 59 59 59 59 59 59 59 59 59 165 16 
16 165 59 59 59 59 59 59 59 59 59 59 59 59 59 59 59 59 59 59 59 59 59 59 59 59 59 59 59 59 59 59 59 59 59 59 59 59 59 59 59 59 59 59 59 59 59 59 59 59 59 59 59 59 59 59 59 59 59 59 59 59 59 59 59 59 59 59 59 59 59 59 59 59 59 59 59 59 59 59 59 59 59 59 59 59 59 59 59 59 59 59 59 59 59 59 59 59 165 16 
16 165 59 59 59 59 59 59 59 59 59 59 59 59 59 59 59 59 59 59 59 59 59 59 59 59 59 59 59 59 59 59 59 59 59 59 59 59 59 59 59 59 59 59 59 59 59 59 59 59 59 59 59 59 59 59 59 59 59 59 59 59 59 59 59 59 59 59 59 59 59 59 59 59 59 59 59 59 59 59 59 59 59 59 59 59 59 59 59 59 59 59 59 59 59 59 59 59 165 16 
16 165 59 59 59 59 59 59 59 59 59 59 59 59 59 59 59 59 59 59 59 59 59 59 59 59 59 59 59 59 59 59 59 59 59 59 59 59 59 59 59 59 59 59 59 59 59 59 59 59 59 59 59 59 59 59 59 59 59 59 59 59 59 59 59 59 59 59 59 59 59 59 59 59 59 59 59 59 59 59 59 59 59 59 59 59 59 59 59 59 59 59 59 59 59 59 59 59 165 16 
16 165 59 59 59 59 59 59 59 59 59 59 59 59 59 59 59 59 59 59 59 59 59 59 59 59 59 59 59 59 59 59 59 59 59 59 59 59 59 59 59 59 59 59 59 59 59 59 59 59 59 59 59 59 59 59 59 59 59 59 59 59 59 59 59 59 59 59 59 59 59 59 59 59 59 59 59 59 59 59 59 59 59 59 59 59 59 59 59 59 59 59 59 59 59 59 59 59 165 16 
16 165 59 59 59 59 59 59 59 59 59 59 59 59 59 59 59 59 59 59 59 59 59 59 59 59 59 59 59 59 59 59 59 59 59 59 59 59 59 59 59 59 59 59 59 59 59 59 59 59 59 59 59 59 59 59 59 59 59 59 59 59 59 59 59 59 59 59 59 59 59 59 59 59 59 59 59 59 59 59 59 59 59 59 59 59 59 59 59 59 59 59 59 59 59 59 59 59 165 16 
16 165 59 59 59 59 59 59 59 59 59 59 59 59 59 59 59 59 59 59 59 59 59 59 59 59 59 59 59 59 59 59 59 59 59 59 59 59 59 59 59 59 59 59 59 59 59 59 59 59 59 59 59 59 59 59 59 59 59 59 59 59 59 59 59 59 59 59 59 59 59 59 59 59 59 59 59 59 59 59 59 59 59 59 59 59 59 59 59 59 59 59 59 59 59 59 59 59 165 16 
16 165 59 59 59 59 59 59 59 59 59 59 59 59 59 59 59 59 59 59 59 59 59 59 59 59 59 59 59 59 59 59 59 59 59 59 59 59 59 59 59 59 59 59 59 59 59 59 59 59 59 59 59 59 59 59 59 59 59 59 59 59 59 59 59 59 59 59 59 59 59 59 59 59 59 59 59 59 59 59 59 59 59 59 59 59 59 59 59 59 59 59 59 59 59 59 59 59 165 16 
16 165 59 59 59 59 59 59 59 59 59 59 59 59 59 59 59 59 59 59 59 59 59 59 59 59 59 59 59 59 59 59 59 59 59 59 59 59 59 59 59 59 59 59 59 59 59 59 59 59 59 59 59 59 59 59 59 59 59 59 59 59 59 59 59 59 59 59 59 59 59 59 59 59 59 59 59 59 59 59 59 59 59 59 59 59 59 59 59 59 59 59 59 59 59 59 59 59 165 16 
16 165 59 59 59 59 59 59 59 59 59 59 59 59 59 59 59 59 59 59 59 59 59 59 59 59 59 59 59 59 59 59 59 59 59 59 59 59 59 59 59 59 59 59 59 59 59 59 59 59 59 59 59 59 59 59 59 59 59 59 59 59 59 59 59 59 59 59 59 59 59 59 59 59 59 59 59 59 59 59 59 59 59 59 59 59 59 59 59 59 59 59 59 59 59 59 59 59 165 16 
16 165 59 59 59 59 59 59 59 59 59 59 59 59 59 59 59 59 59 59 59 59 59 59 59 59 59 59 59 59 59 59 59 59 59 59 59 59 59 59 59 59 59 59 59 59 59 59 59 59 59 59 59 59 59 59 59 59 59 59 59 59 59 59 59 59 59 59 59 59 59 59 59 59 59 59 59 59 59 59 59 59 59 59 59 59 59 59 59 59 59 59 59 59 59 59 59 59 165 16 
16 165 59 59 59 59 59 59 59 59 59 59 59 59 59 59 59 59 59 59 59 59 59 59 59 59 59 59 59 59 59 59 59 59 59 59 59 59 59 59 59 59 59 59 59 59 59 59 59 59 59 59 59 59 59 59 59 59 59 59 59 59 59 59 59 59 59 59 59 59 59 59 59 59 59 59 59 59 59 59 59 59 59 59 59 59 59 59 59 59 59 59 59 59 59 59 59 59 165 16 
16 165 59 59 59 59 59 59 59 59 59 59 59 59 59 59 59 59 59 59 59 59 59 59 59 59 59 59 59 59 59 59 59 59 59 59 59 59 59 59 59 59 59 59 59 59 59 59 59 59 59 59 59 59 59 59 59 59 59 59 59 59 59 59 59 59 59 59 59 59 59 59 59 59 59 59 59 59 59 59 59 59 59 59 59 59 59 59 59 59 59 59 59 59 59 59 59 59 165 16 
16 165 165 165 165 165 165 165 165 165 165 165 165 165 165 165 165 165 165 165 165 165 165 165 165 165 165 165 165 165 165 165 165 165 165 165 165 165 165 165 165 165 165 165 165 165 165 165 165 165 165 165 165 165 165 165 165 165 165 165 165 165 165 165 165 165 165 165 165 165 165 165 165 165 165 165 165 165 165 165 165 165 165 165 165 165 165 165 165 165 165 165 165 165 165 165 165 165 165 16 
16 0 0 0 0 0 0 0 0 0 0 0 0 0 0 0 0 0 0 0 0 0 0 0 0 0 0 0 0 0 0 0 0 0 0 0 0 0 0 0 0 0 0 0 0 0 0 0 0 0 0 0 0 0 0 0 0 0 0 0 0 0 0 0 0 0 0 0 0 0 0 0 0 0 0 0 0 0 0 0 0 0 0 0 0 0 0 0 0 0 0 0 0 0 0 0 0 0 0 16 
16 0 0 0 0 0 0 0 0 0 0 0 0 0 0 0 0 0 0 0 0 0 0 0 0 0 0 0 0 0 0 0 0 0 0 0 0 0 0 0 0 0 0 0 0 0 0 0 0 0 0 0 0 0 0 0 0 0 0 0 0 0 0 0 0 0 0 0 0 0 0 0 0 0 0 0 0 0 0 0 0 0 0 0 0 0 0 0 0 0 0 0 0 0 0 0 0 0 0 16 
16 0 0 0 0 0 0 0 0 0 0 0 0 0 0 0 0 0 0 0 0 0 0 0 0 0 0 0 0 0 0 0 0 0 0 0 0 0 0 0 0 0 0 0 0 0 0 0 0 0 0 0 0 0 0 0 0 0 0 0 0 0 0 0 0 0 0 0 0 0 0 0 0 0 0 0 0 0 0 0 0 0 0 0 0 0 0 0 0 0 0 0 0 0 0 0 0 0 0 16 
16 0 0 0 0 0 0 0 0 0 0 0 0 0 0 0 0 0 0 0 0 0 0 0 0 0 0 0 0 0 0 0 0 0 0 0 0 0 0 0 0 0 0 0 0 0 0 0 0 0 0 0 0 0 0 0 0 0 0 0 0 0 0 0 0 0 0 0 0 0 0 0 0 0 0 0 0 0 0 0 0 0 0 0 0 0 0 0 0 0 0 0 0 0 0 0 0 0 0 16 
16 0 0 0 0 0 0 0 0 0 0 0 0 0 0 0 0 0 0 0 0 0 0 0 0 0 0 0 0 0 0 0 0 0 0 0 0 0 0 0 0 0 0 0 0 0 0 0 0 0 0 0 0 0 0 0 0 0 0 0 0 0 0 0 0 0 0 0 0 0 0 0 0 0 0 0 0 0 0 0 0 0 0 0 0 0 0 0 0 0 0 0 0 0 0 0 0 0 0 16 
16 0 0 0 0 0 0 0 0 0 0 0 0 0 0 0 0 0 0 0 0 0 0 0 0 0 0 0 0 0 0 0 0 0 0 0 0 0 0 0 0 0 0 0 0 0 0 0 0 0 0 0 0 0 0 0 0 0 0 0 0 0 0 0 0 0 0 0 0 0 0 0 0 0 0 0 0 0 0 0 0 0 0 0 0 0 0 0 0 0 0 0 0 0 0 0 0 0 0 16 
16 0 0 0 0 0 0 0 0 0 0 0 0 0 0 0 0 0 0 0 0 0 0 0 0 0 0 0 0 0 0 0 0 0 0 0 0 0 0 0 0 0 0 0 0 0 0 0 0 0 0 0 0 0 0 0 0 0 0 0 0 0 0 0 0 0 0 0 0 0 0 0 0 0 0 0 0 0 0 0 0 0 0 0 0 0 0 0 0 0 0 0 0 0 0 0 0 0 0 16 
16 0 0 0 0 0 0 0 0 0 0 0 0 0 0 0 0 0 0 0 0 0 0 0 0 0 0 0 0 0 0 0 0 0 0 0 0 0 0 0 0 0 0 0 0 0 0 0 0 0 0 0 0 0 0 0 0 0 0 0 0 0 0 0 0 0 0 0 0 0 0 0 0 0 0 0 0 0 0 0 0 0 0 0 0 0 0 0 0 0 0 0 0 0 0 0 0 0 0 16 
16 0 0 0 0 0 0 0 0 0 0 0 0 0 0 0 0 0 0 0 0 0 0 0 0 0 0 0 0 0 0 0 0 0 0 0 0 0 0 0 0 0 0 0 0 0 0 0 0 0 0 0 0 0 0 0 0 0 0 0 0 0 0 0 0 0 0 0 0 0 0 0 0 0 0 0 0 0 0 0 0 0 0 0 0 0 0 0 0 0 0 0 0 0 0 0 0 0 0 16 
16 0 0 0 0 0 0 0 0 0 0 0 0 0 0 0 0 0 0 0 0 0 0 0 0 0 0 0 0 0 0 0 0 0 0 0 0 0 0 0 0 0 0 0 0 0 0 0 0 0 0 0 0 0 0 0 0 0 0 0 0 0 0 0 0 0 0 0 0 0 0 0 0 0 0 0 0 0 0 0 0 0 0 0 0 0 0 0 0 0 0 0 0 0 0 0 0 0 0 16 
16 0 0 0 0 0 0 0 0 0 0 0 0 0 0 0 0 0 0 0 0 0 0 0 0 0 0 0 0 0 0 0 0 0 0 0 0 0 0 0 0 0 0 0 0 0 0 0 0 0 0 0 0 0 0 0 0 0 0 0 0 0 0 0 0 0 0 0 0 0 0 0 0 0 0 0 0 0 0 0 0 0 0 0 0 0 0 0 0 0 0 0 0 0 0 0 0 0 0 16 
16 0 0 0 0 0 0 0 0 0 0 0 0 0 0 0 0 0 0 0 0 0 0 0 0 0 0 0 0 0 0 0 0 0 0 0 0 0 0 0 0 0 0 0 0 0 0 0 0 0 0 0 0 0 0 0 0 0 0 0 0 0 0 0 0 0 0 0 0 0 0 0 0 0 0 0 0 0 0 0 0 0 0 0 0 0 0 0 0 0 0 0 0 0 0 0 0 0 0 16 
16 0 0 0 0 0 0 0 0 0 0 0 0 0 0 0 0 0 0 0 0 0 0 0 0 0 0 0 0 0 0 0 0 0 0 0 0 0 0 0 0 0 0 0 0 0 0 0 0 0 0 0 0 0 0 0 0 0 0 0 0 0 0 0 0 0 0 0 0 0 0 0 0 0 0 0 0 0 0 0 0 0 0 0 0 0 0 0 0 0 0 0 0 0 0 0 0 0 0 16 
16 0 0 0 0 0 0 0 0 0 0 0 0 0 0 0 0 0 0 0 0 0 0 0 0 0 0 0 0 0 0 0 0 0 0 0 0 0 0 0 0 0 0 0 0 0 0 0 0 0 0 0 0 0 0 0 0 0 0 0 0 0 0 0 0 0 0 0 0 0 0 0 0 0 0 0 0 0 0 0 0 0 0 0 0 0 0 0 0 0 0 0 0 0 0 0 0 0 0 16 
16 0 0 0 0 0 0 0 0 0 0 0 0 0 0 0 0 0 0 0 0 0 0 0 0 0 0 0 0 0 0 0 0 0 0 0 0 0 0 0 0 0 0 0 0 0 0 0 0 0 0 0 0 0 0 0 0 0 0 0 0 0 0 0 0 0 0 0 0 0 0 0 0 0 0 0 0 0 0 0 0 0 0 0 0 0 0 0 0 0 0 0 0 0 0 0 0 0 0 16 
16 0 0 0 0 0 0 0 0 0 0 0 0 0 0 0 0 0 0 0 0 0 0 0 0 0 0 0 0 0 0 0 0 0 0 0 0 0 0 0 0 0 0 0 0 0 0 0 0 0 0 0 0 0 0 0 0 0 0 0 0 0 0 0 0 0 0 0 0 0 0 0 0 0 0 0 0 0 0 0 0 0 0 0 0 0 0 0 0 0 0 0 0 0 0 0 0 0 0 16 
16 0 0 0 0 0 0 0 0 0 0 0 0 0 0 0 0 0 0 0 0 0 0 0 0 0 0 0 0 0 0 0 0 0 0 0 0 0 0 0 0 0 0 0 0 0 0 0 0 0 0 0 0 0 0 0 0 0 0 0 0 0 0 0 0 0 0 0 0 0 0 0 0 0 0 0 0 0 0 0 0 0 0 0 0 0 0 0 0 0 0 0 0 0 0 0 0 0 0 16 
16 0 0 0 0 0 0 0 0 0 0 0 0 0 0 0 0 0 0 0 0 0 0 0 0 0 0 0 0 0 0 0 0 0 0 0 0 0 0 0 0 0 0 0 0 0 0 0 0 0 0 0 0 0 0 0 0 0 0 0 0 0 0 0 0 0 0 0 0 0 0 0 0 0 0 0 0 0 0 0 0 0 0 0 0 0 0 0 0 0 0 0 0 0 0 0 0 0 0 16 
16 0 0 0 0 0 0 0 0 0 0 0 0 0 0 0 0 0 0 0 0 0 0 0 0 0 0 0 0 0 0 0 0 0 0 0 0 0 0 0 0 0 0 0 0 0 0 0 0 0 0 0 0 0 0 0 0 0 0 0 0 0 0 0 0 0 0 0 0 0 0 0 0 0 0 0 0 0 0 0 0 0 0 0 0 0 0 0 0 0 0 0 0 0 0 0 0 0 0 16 
16 0 0 0 0 0 0 0 0 0 0 0 0 0 0 0 0 0 0 0 0 0 0 0 0 0 0 0 0 0 0 0 0 0 0 0 0 0 0 0 0 0 0 0 0 0 0 0 0 0 0 0 0 0 0 0 0 0 0 0 0 0 0 0 0 0 0 0 0 0 0 0 0 0 0 0 0 0 0 0 0 0 0 0 0 0 0 0 0 0 0 0 0 0 0 0 0 0 0 16 
16 0 0 0 0 0 0 0 0 0 0 0 0 0 0 0 0 0 0 0 0 0 0 0 0 0 0 0 0 0 0 0 0 0 0 0 0 0 0 0 0 0 0 0 0 0 0 0 0 0 0 0 0 0 0 0 0 0 0 0 0 0 0 0 0 0 0 0 0 0 0 0 0 0 0 0 0 0 0 0 0 0 0 0 0 0 0 0 0 0 0 0 0 0 0 0 0 0 0 16 
16 0 0 0 0 0 0 0 0 0 0 0 0 0 0 0 0 0 0 0 0 0 0 0 0 0 0 0 0 0 0 0 0 0 0 0 0 0 0 0 0 0 0 0 0 0 0 0 0 0 0 0 0 0 0 0 0 0 0 0 0 0 0 0 0 0 0 0 0 0 0 0 0 0 0 0 0 0 0 0 0 0 0 0 0 0 0 0 0 0 0 0 0 0 0 0 0 0 0 16 
16 0 0 0 0 0 0 0 0 0 0 0 0 0 0 0 0 0 0 0 0 0 0 0 0 0 0 0 0 0 0 0 0 0 0 0 0 0 0 0 0 0 0 0 0 0 0 0 0 0 0 0 0 0 0 0 0 0 0 0 0 0 0 0 0 0 0 0 0 0 0 0 0 0 0 0 0 0 0 0 0 0 0 0 0 0 0 0 0 0 0 0 0 0 0 0 0 0 0 16 
16 0 0 0 0 0 0 0 0 0 0 0 0 0 0 0 0 0 0 0 0 0 0 0 0 0 0 0 0 0 0 0 0 0 0 0 0 0 0 0 0 0 0 0 0 0 0 0 0 0 0 0 0 0 0 0 0 0 0 0 0 0 0 0 0 0 0 0 0 0 0 0 0 0 0 0 0 0 0 0 0 0 0 0 0 0 0 0 0 0 0 0 0 0 0 0 0 0 0 16 
16 0 0 0 0 0 0 0 0 0 0 0 0 0 0 0 0 0 0 0 0 0 0 0 0 0 0 0 0 0 0 0 0 0 0 0 0 0 0 0 0 0 0 0 0 0 0 0 0 0 0 0 0 0 0 0 0 0 0 0 0 0 0 0 0 0 0 0 0 0 0 0 0 0 0 0 0 0 0 0 0 0 0 0 0 0 0 0 0 0 0 0 0 0 0 0 0 0 0 16 
16 0 0 0 0 0 0 0 0 0 0 0 0 0 0 0 0 0 0 0 0 0 0 0 0 0 0 0 0 0 0 0 0 0 0 0 0 0 0 0 0 0 0 0 0 0 0 0 0 0 0 0 0 0 0 0 0 0 0 0 0 0 0 0 0 0 0 0 0 0 0 0 0 0 0 0 0 0 0 0 0 0 0 0 0 0 0 0 0 0 0 0 0 0 0 0 0 0 0 16 
16 0 0 0 0 0 0 0 0 0 0 0 0 0 0 0 0 0 0 0 0 0 0 0 0 0 0 0 0 0 0 0 0 0 0 0 0 0 0 0 0 0 0 0 0 0 0 0 0 0 0 0 0 0 0 0 0 0 0 0 0 0 0 0 0 0 0 0 0 0 0 0 0 0 0 0 0 0 0 0 0 0 0 0 0 0 0 0 0 0 0 0 0 0 0 0 0 0 0 16 
16 0 0 0 0 0 0 0 0 0 0 0 0 0 0 0 0 0 0 0 0 0 0 0 0 0 0 0 0 0 0 0 0 0 0 0 0 0 0 0 0 0 0 0 0 0 0 0 0 0 0 0 0 0 0 0 0 0 0 0 0 0 0 0 0 0 0 0 0 0 0 0 0 0 0 0 0 0 0 0 0 0 0 0 0 0 0 0 0 0 0 0 0 0 0 0 0 0 0 16 
16 0 0 0 0 0 0 0 0 0 0 0 0 0 0 0 0 0 0 0 0 0 0 0 0 0 0 0 0 0 0 0 0 0 0 0 0 0 0 0 0 0 0 0 0 0 0 0 0 0 0 0 0 0 0 0 0 0 0 0 0 0 0 0 0 0 0 0 0 0 0 0 0 0 0 0 0 0 0 0 0 0 0 0 0 0 0 0 0 0 0 0 0 0 0 0 0 0 0 16 
16 0 0 0 0 0 0 0 0 0 0 0 0 0 0 0 0 0 0 0 0 0 0 0 0 0 0 0 0 0 0 0 0 0 0 0 0 0 0 0 0 0 0 0 0 0 0 0 0 0 0 0 0 0 0 0 0 0 0 0 0 0 0 0 0 0 0 0 0 0 0 0 0 0 0 0 0 0 0 0 0 0 0 0 0 0 0 0 0 0 0 0 0 0 0 0 0 0 0 16 
16 0 0 0 0 0 0 0 0 0 0 0 0 0 0 0 0 0 0 0 0 0 0 0 0 0 0 0 0 0 0 0 0 0 0 0 0 0 0 0 0 0 0 0 0 0 0 0 0 0 0 0 0 0 0 0 0 0 0 0 0 0 0 0 0 0 0 0 0 0 0 0 0 0 0 0 0 0 0 0 0 0 0 0 0 0 0 0 0 0 0 0 0 0 0 0 0 0 0 16 
16 0 0 0 0 0 0 0 0 0 0 0 0 0 0 0 0 0 0 0 0 0 0 0 0 0 0 0 0 0 0 0 0 0 0 0 0 0 0 0 0 0 0 0 0 0 0 0 0 0 0 0 0 0 0 0 0 0 0 0 0 0 0 0 0 0 0 0 0 0 0 0 0 0 0 0 0 0 0 0 0 0 0 0 0 0 0 0 0 0 0 0 0 0 0 0 0 0 0 16 
16 0 0 0 0 0 0 0 0 0 0 0 0 0 0 0 0 0 0 0 0 0 0 0 0 0 0 0 0 0 0 0 0 0 0 0 0 0 0 0 0 0 0 0 0 0 0 0 0 0 0 0 0 0 0 0 0 0 0 0 0 0 0 0 0 0 0 0 0 0 0 0 0 0 0 0 0 0 0 0 0 0 0 0 0 0 0 0 0 0 0 0 0 0 0 0 0 0 0 16 
16 0 0 0 0 0 0 0 0 0 0 0 0 0 0 0 0 0 0 0 0 0 0 0 0 0 0 0 0 0 0 0 0 0 0 0 0 0 0 0 0 0 0 0 0 0 0 0 0 0 0 0 0 0 0 0 0 0 0 0 0 0 0 0 0 0 0 0 0 0 0 0 0 0 0 0 0 0 0 0 0 0 0 0 0 0 0 0 0 0 0 0 0 0 0 0 0 0 0 16 
16 16 16 16 16 16 16 16 16 16 16 16 16 16 16 16 16 16 16 16 16 16 16 16 16 16 16 16 16 16 16 16 16 16 16 16 16 16 16 16 16 16 16 16 16 16 16 16 16 16 16 16 16 16 16 16 16 16 16 16 16 16 16 16 16 16 16 16 16 16 16 16 16 16 16 16 16 16 16 16 16 16 16 16 16 16 16 16 16 16 16 16 16 16 16 16 16 16 16 16 
